20
11
10 0 0 0 0 0 0 0 0 0 0 0 0 0 0 0 0 0 0 10
10 0 0 0 0 0 0 0 0 0 0 0 0 0 0 0 0 0 0 10
10 0 0 0 0 0 0 0 0 0 0 0 0 0 0 0 0 0 0 10
10 0 0 0 0 0 0 0 0 0 0 0 0 0 0 0 0 0 0 10
10 0 0 0 0 0 0 0 0 0 0 0 0 0 0 0 0 0 0 10
10 0 0 0 0 0 0 0 0 0 0 0 0 0 0 0 0 0 0 10
10 0 0 0 0 0 0 0 0 0 0 0 0 0 0 0 0 0 0 10
10 0 0 0 0 0 0 0 0 0 0 0 0 0 0 0 0 0 0 10
10 0 0 0 0 0 0 0 0 0 0 0 0 0 0 0 0 0 0 10
10 10 10 10 10 10 11 12 13 12 12 12 12 13 14 10 10 10 10 10 
3 1 2 2 1 2 3 4 6 7 8 7 5 6 9 3 2 2 2 1
